Привіт Світе|Hello World
Значення|Values
Змінні|Variables
Константи|Constants
Цикл For|For
Розгалуження Умови - Якщо/Інакше (If/Else)|If/Else
Розгалуження Умови - Перемикач (Switch)|Switch
Масиви (Arrays)|Arrays
Зрізи (Slices)|Slices
Мапи|Maps
Діапазон (Range)|Range
Функції|Functions
Поверненння Кількох Значень|Multiple Return Values
Варіативні Функції|Variadic Functions
Замикання|Closures
Рекурсія|Recursion
Вказівники|Pointers
Структури|Structs
Методи|Methods
Інтерфейси|Interfaces
Помилки|Errors
Goroutines|Goroutines
Канали|Channels
Буферизація Каналу|Channel Buffering
Синзронізація Каналу|Channel Synchronization
Напрямки каналу|Channel Directions
Select
Тайм-аути|Timeouts
Не Блокуючі Операції на Каналах|Non-Blocking Channel Operations
Закриття каналів|Closing Channels
Діапазон (Range) з Каналами|Range over Channels
Таймери|Timers
Маятники|Tickers
Worker Pools
Обмеження Частоти|Rate Limiting
Атомарні Лічильники|Atomic Counters
Mutexes
Stateful Goroutines
Сортування|Sorting
Sorting by Functions
Паніка|Panic
Відкладення|Defer
Функцій для роботи з колекціями|Collection Functions
Рядкові Функції|String Functions
Форматування Рядків|String Formatting
Регулярні вирази|Regular Expressions
JSON
Time
Epoch
Time Formatting / Parsing
Random Numbers
Number Parsing
URL Parsing
SHA1 Hashes
Base64 Encoding
Reading Files
Writing Files
Line Filters
Аргументи командного рядку|Command-Line Arguments
Прапорці командного рядку|Command-Line Flags
Environment Variables
Spawning Processes
Exec'ing Processes
Signals
Exit
